Date,ProductID,BrandID,Price,Discount,DatePlacedOnStack,Visitors,Buyers,Difference
2024-07-01,1001,B01,43.91,26,2024-06-23,171,94,77
2024-07-02,1001,B01,43.63,24,2024-06-23,149,123,26
2024-07-03,1001,B01,44.13,25,2024-06-23,102,21,81
2024-07-04,1001,B01,44.15,25,2024-06-23,87,21,66
2024-07-05,1001,B01,43.07,24,2024-06-23,210,77,133
2024-07-06,1001,B01,43.76,24,2024-06-23,98,78,20
2024-07-07,1001,B01,43.51,26,2024-06-23,239,209,30
2024-07-08,1001,B01,44.28,26,2024-06-23,157,74,83
2024-07-09,1001,B01,44.68,24,2024-06-23,180,70,110
2024-07-10,1001,B01,44.07,24,2024-06-23,216,37,179
2024-07-11,1001,B01,44.61,25,2024-06-23,291,284,7
2024-07-12,1001,B01,42.74,25,2024-06-23,133,111,22
2024-07-13,1001,B01,43.59,26,2024-06-23,221,27,194
2024-07-14,1001,B01,42.78,25,2024-06-23,130,55,75
2024-07-15,1001,B01,43.07,25,2024-06-23,183,73,110
2024-07-16,1001,B01,43.8,25,2024-06-23,270,210,60
2024-07-17,1001,B01,44.39,25,2024-06-23,251,209,42
2024-07-18,1001,B01,44.56,26,2024-06-23,97,34,63
2024-07-19,1001,B01,42.89,26,2024-06-23,298,209,89
2024-07-20,1001,B01,43.36,24,2024-06-23,131,130,1
2024-07-21,1001,B01,44.37,25,2024-06-23,266,207,59
2024-07-22,1001,B01,43.8,24,2024-06-23,206,34,172
2024-07-23,1001,B01,43.04,24,2024-06-23,120,28,92
2024-07-24,1001,B01,44.25,26,2024-06-23,188,100,88
2024-07-25,1001,B01,44.13,26,2024-06-23,82,78,4
2024-07-26,1001,B01,42.86,26,2024-06-23,299,60,239
2024-07-27,1001,B01,44.54,24,2024-06-23,121,31,90
2024-07-28,1001,B01,43.37,26,2024-06-23,200,81,119
2024-07-29,1001,B01,43.36,26,2024-06-23,221,123,98
2024-07-30,1001,B01,43.26,26,2024-06-23,242,120,122
2024-07-01,1002,B02,97.89,16,2024-06-30,191,122,69
2024-07-02,1002,B02,96.53,16,2024-06-30,64,45,19
2024-07-03,1002,B02,96.5,14,2024-06-30,228,82,146
2024-07-04,1002,B02,98.24,14,2024-06-30,101,23,78
2024-07-05,1002,B02,98.27,16,2024-06-30,280,256,24
2024-07-06,1002,B02,97.53,14,2024-06-30,85,32,53
2024-07-07,1002,B02,96.6,16,2024-06-30,292,105,187
2024-07-08,1002,B02,98.21,15,2024-06-30,94,81,13
2024-07-09,1002,B02,97.72,15,2024-06-30,77,47,30
2024-07-10,1002,B02,96.89,15,2024-06-30,239,94,145
2024-07-11,1002,B02,97.1,16,2024-06-30,141,108,33
2024-07-12,1002,B02,97.09,14,2024-06-30,178,140,38
2024-07-13,1002,B02,97.75,14,2024-06-30,165,22,143
2024-07-14,1002,B02,96.46,16,2024-06-30,186,81,105
2024-07-15,1002,B02,96.89,16,2024-06-30,283,191,92
2024-07-16,1002,B02,96.94,16,2024-06-30,167,115,52
2024-07-17,1002,B02,97.57,14,2024-06-30,111,77,34
2024-07-18,1002,B02,98.37,15,2024-06-30,88,21,67
2024-07-19,1002,B02,97.87,14,2024-06-30,162,100,62
2024-07-20,1002,B02,96.98,15,2024-06-30,179,73,106
2024-07-21,1002,B02,96.52,14,2024-06-30,178,166,12
2024-07-22,1002,B02,97.81,14,2024-06-30,221,179,42
2024-07-23,1002,B02,97.56,16,2024-06-30,117,74,43
2024-07-24,1002,B02,97.97,16,2024-06-30,194,57,137
2024-07-25,1002,B02,97.19,15,2024-06-30,247,233,14
2024-07-26,1002,B02,97.52,14,2024-06-30,250,143,107
2024-07-27,1002,B02,97.47,14,2024-06-30,52,39,13
2024-07-28,1002,B02,97.1,16,2024-06-30,139,86,53
2024-07-29,1002,B02,98.07,16,2024-06-30,101,52,49
2024-07-30,1002,B02,97.25,16,2024-06-30,131,123,8
2024-07-01,1003,B03,21.61,21,2024-06-22,208,61,147
2024-07-02,1003,B03,21.9,20,2024-06-22,161,79,82
2024-07-03,1003,B03,21.9,19,2024-06-22,97,31,66
2024-07-04,1003,B03,22.5,21,2024-06-22,296,28,268
2024-07-05,1003,B03,21.94,21,2024-06-22,97,22,75
2024-07-06,1003,B03,23.09,20,2024-06-22,169,135,34
2024-07-07,1003,B03,21.55,20,2024-06-22,153,103,50
2024-07-08,1003,B03,22.54,20,2024-06-22,266,118,148
2024-07-09,1003,B03,23.33,20,2024-06-22,177,129,48
2024-07-10,1003,B03,22.48,20,2024-06-22,212,208,4
2024-07-11,1003,B03,21.83,19,2024-06-22,117,52,65
2024-07-12,1003,B03,22.37,21,2024-06-22,244,164,80
2024-07-13,1003,B03,22.0,21,2024-06-22,164,138,26
2024-07-14,1003,B03,21.88,20,2024-06-22,87,70,17
2024-07-15,1003,B03,23.16,21,2024-06-22,76,53,23
2024-07-16,1003,B03,22.08,19,2024-06-22,77,66,11
2024-07-17,1003,B03,22.37,19,2024-06-22,110,67,43
2024-07-18,1003,B03,21.94,21,2024-06-22,241,68,173
2024-07-19,1003,B03,21.47,20,2024-06-22,270,65,205
2024-07-20,1003,B03,23.21,21,2024-06-22,173,56,117
2024-07-21,1003,B03,23.24,19,2024-06-22,95,72,23
2024-07-22,1003,B03,22.52,19,2024-06-22,165,86,79
2024-07-23,1003,B03,21.72,19,2024-06-22,283,242,41
2024-07-24,1003,B03,23.07,21,2024-06-22,153,43,110
2024-07-25,1003,B03,21.8,21,2024-06-22,135,42,93
2024-07-26,1003,B03,21.66,21,2024-06-22,283,123,160
2024-07-27,1003,B03,22.77,21,2024-06-22,295,195,100
2024-07-28,1003,B03,22.49,20,2024-06-22,296,45,251
2024-07-29,1003,B03,23.0,19,2024-06-22,201,32,169
2024-07-30,1003,B03,21.54,21,2024-06-22,106,55,51
2024-07-01,1004,B04,82.25,5,2024-06-23,253,134,119
2024-07-02,1004,B04,81.53,5,2024-06-23,115,51,64
2024-07-03,1004,B04,82.01,5,2024-06-23,100,44,56
2024-07-04,1004,B04,81.16,5,2024-06-23,174,169,5
2024-07-05,1004,B04,82.03,5,2024-06-23,98,71,27
2024-07-06,1004,B04,80.93,6,2024-06-23,103,79,24
2024-07-07,1004,B04,81.5,4,2024-06-23,109,24,85
2024-07-08,1004,B04,81.76,5,2024-06-23,158,135,23
2024-07-09,1004,B04,81.67,6,2024-06-23,104,59,45
2024-07-10,1004,B04,82.3,4,2024-06-23,163,143,20
2024-07-11,1004,B04,82.28,6,2024-06-23,194,139,55
2024-07-12,1004,B04,81.39,5,2024-06-23,232,109,123
2024-07-13,1004,B04,80.9,4,2024-06-23,111,42,69
2024-07-14,1004,B04,81.71,4,2024-06-23,178,77,101
2024-07-15,1004,B04,82.68,6,2024-06-23,83,51,32
2024-07-16,1004,B04,81.95,4,2024-06-23,281,256,25
2024-07-17,1004,B04,81.41,4,2024-06-23,280,211,69
2024-07-18,1004,B04,81.96,5,2024-06-23,142,138,4
2024-07-19,1004,B04,80.95,5,2024-06-23,193,105,88
2024-07-20,1004,B04,80.88,5,2024-06-23,269,88,181
2024-07-21,1004,B04,81.04,5,2024-06-23,287,223,64
2024-07-22,1004,B04,80.88,5,2024-06-23,225,104,121
2024-07-23,1004,B04,81.8,4,2024-06-23,271,120,151
2024-07-24,1004,B04,81.65,5,2024-06-23,295,119,176
2024-07-25,1004,B04,80.94,6,2024-06-23,187,166,21
2024-07-26,1004,B04,81.86,4,2024-06-23,297,23,274
2024-07-27,1004,B04,82.08,6,2024-06-23,51,36,15
2024-07-28,1004,B04,82.58,6,2024-06-23,133,43,90
2024-07-29,1004,B04,82.2,6,2024-06-23,173,52,121
2024-07-30,1004,B04,81.77,6,2024-06-23,220,120,100
2024-07-01,1005,B05,66.63,6,2024-06-30,93,48,45
2024-07-02,1005,B05,65.47,6,2024-06-30,95,21,74
2024-07-03,1005,B05,65.41,5,2024-06-30,84,42,42
2024-07-04,1005,B05,65.47,4,2024-06-30,203,109,94
2024-07-05,1005,B05,66.01,6,2024-06-30,154,77,77
2024-07-06,1005,B05,66.72,4,2024-06-30,124,48,76
2024-07-07,1005,B05,65.41,4,2024-06-30,70,55,15
2024-07-08,1005,B05,65.68,4,2024-06-30,201,196,5
2024-07-09,1005,B05,66.79,5,2024-06-30,290,115,175
2024-07-10,1005,B05,66.01,5,2024-06-30,273,56,217
2024-07-11,1005,B05,65.81,6,2024-06-30,62,42,20
2024-07-12,1005,B05,66.84,4,2024-06-30,79,36,43
2024-07-13,1005,B05,66.4,4,2024-06-30,135,32,103
2024-07-14,1005,B05,67.12,4,2024-06-30,149,95,54
2024-07-15,1005,B05,66.04,5,2024-06-30,272,147,125
2024-07-16,1005,B05,66.3,5,2024-06-30,160,136,24
2024-07-17,1005,B05,65.51,4,2024-06-30,229,142,87
2024-07-18,1005,B05,65.76,4,2024-06-30,200,163,37
2024-07-19,1005,B05,66.91,4,2024-06-30,230,61,169
2024-07-20,1005,B05,67.28,5,2024-06-30,272,141,131
2024-07-21,1005,B05,66.21,6,2024-06-30,270,254,16
2024-07-22,1005,B05,66.74,6,2024-06-30,125,28,97
2024-07-23,1005,B05,66.85,4,2024-06-30,279,26,253
2024-07-24,1005,B05,66.18,5,2024-06-30,186,46,140
2024-07-25,1005,B05,66.74,4,2024-06-30,78,56,22
2024-07-26,1005,B05,65.8,4,2024-06-30,114,105,9
2024-07-27,1005,B05,66.96,6,2024-06-30,120,108,12
2024-07-28,1005,B05,66.51,5,2024-06-30,208,38,170
2024-07-29,1005,B05,66.88,5,2024-06-30,216,110,106
2024-07-30,1005,B05,65.83,6,2024-06-30,88,86,2
2024-07-01,1006,B06,32.07,9,2024-06-27,176,124,52
2024-07-02,1006,B06,33.32,11,2024-06-27,254,111,143
2024-07-03,1006,B06,33.75,11,2024-06-27,162,75,87
2024-07-04,1006,B06,32.89,9,2024-06-27,183,77,106
2024-07-05,1006,B06,31.85,9,2024-06-27,110,66,44
2024-07-06,1006,B06,33.61,10,2024-06-27,262,222,40
2024-07-07,1006,B06,33.67,11,2024-06-27,196,39,157
2024-07-08,1006,B06,31.98,11,2024-06-27,282,33,249
2024-07-09,1006,B06,32.42,9,2024-06-27,166,73,93
2024-07-10,1006,B06,33.0,11,2024-06-27,234,222,12
2024-07-11,1006,B06,32.39,10,2024-06-27,253,171,82
2024-07-12,1006,B06,33.07,10,2024-06-27,141,55,86
2024-07-13,1006,B06,32.76,10,2024-06-27,109,69,40
2024-07-14,1006,B06,32.36,9,2024-06-27,90,83,7
2024-07-15,1006,B06,32.74,11,2024-06-27,194,180,14
2024-07-16,1006,B06,32.65,9,2024-06-27,269,259,10
2024-07-17,1006,B06,32.16,10,2024-06-27,84,80,4
2024-07-18,1006,B06,33.71,11,2024-06-27,246,66,180
2024-07-19,1006,B06,33.67,10,2024-06-27,105,49,56
2024-07-20,1006,B06,33.56,9,2024-06-27,54,52,2
2024-07-21,1006,B06,33.39,10,2024-06-27,273,258,15
2024-07-22,1006,B06,32.13,9,2024-06-27,75,44,31
2024-07-23,1006,B06,33.77,11,2024-06-27,226,224,2
2024-07-24,1006,B06,31.96,9,2024-06-27,148,146,2
2024-07-25,1006,B06,32.38,11,2024-06-27,55,47,8
2024-07-26,1006,B06,33.46,11,2024-06-27,182,121,61
2024-07-27,1006,B06,33.66,11,2024-06-27,278,72,206
2024-07-28,1006,B06,33.72,10,2024-06-27,132,36,96
2024-07-29,1006,B06,32.31,9,2024-06-27,159,20,139
2024-07-30,1006,B06,33.74,9,2024-06-27,53,20,33
2024-07-01,1007,B07,69.49,10,2024-06-23,211,201,10
2024-07-02,1007,B07,70.99,11,2024-06-23,99,31,68
2024-07-03,1007,B07,71.08,9,2024-06-23,271,241,30
2024-07-04,1007,B07,71.03,9,2024-06-23,161,66,95
2024-07-05,1007,B07,70.29,9,2024-06-23,134,33,101
2024-07-06,1007,B07,70.86,11,2024-06-23,152,57,95
2024-07-07,1007,B07,70.67,10,2024-06-23,79,34,45
2024-07-08,1007,B07,70.32,11,2024-06-23,275,71,204
2024-07-09,1007,B07,70.54,9,2024-06-23,265,98,167
2024-07-10,1007,B07,70.24,11,2024-06-23,155,70,85
2024-07-11,1007,B07,70.85,9,2024-06-23,181,157,24
2024-07-12,1007,B07,71.3,10,2024-06-23,66,39,27
2024-07-13,1007,B07,70.37,10,2024-06-23,55,21,34
2024-07-14,1007,B07,70.11,11,2024-06-23,92,42,50
2024-07-15,1007,B07,69.71,11,2024-06-23,252,137,115
2024-07-16,1007,B07,70.85,9,2024-06-23,244,115,129
2024-07-17,1007,B07,70.4,9,2024-06-23,209,197,12
2024-07-18,1007,B07,70.65,11,2024-06-23,196,40,156
2024-07-19,1007,B07,69.79,10,2024-06-23,110,41,69
2024-07-20,1007,B07,69.63,9,2024-06-23,182,31,151
2024-07-21,1007,B07,69.86,10,2024-06-23,226,97,129
2024-07-22,1007,B07,70.11,11,2024-06-23,122,45,77
2024-07-23,1007,B07,71.05,9,2024-06-23,263,258,5
2024-07-24,1007,B07,70.47,11,2024-06-23,112,67,45
2024-07-25,1007,B07,69.57,10,2024-06-23,85,20,65
2024-07-26,1007,B07,69.62,11,2024-06-23,229,226,3
2024-07-27,1007,B07,70.52,10,2024-06-23,63,45,18
2024-07-28,1007,B07,70.97,10,2024-06-23,265,149,116
2024-07-29,1007,B07,70.94,10,2024-06-23,236,75,161
2024-07-30,1007,B07,69.72,11,2024-06-23,160,126,34
2024-07-01,1008,B08,57.78,26,2024-06-29,164,34,130
2024-07-02,1008,B08,57.1,26,2024-06-29,278,47,231
2024-07-03,1008,B08,56.93,24,2024-06-29,66,58,8
2024-07-04,1008,B08,57.07,25,2024-06-29,93,44,49
2024-07-05,1008,B08,58.67,24,2024-06-29,117,29,88
2024-07-06,1008,B08,58.47,24,2024-06-29,195,130,65
2024-07-07,1008,B08,58.06,25,2024-06-29,83,66,17
2024-07-08,1008,B08,58.38,24,2024-06-29,285,102,183
2024-07-09,1008,B08,57.65,24,2024-06-29,55,45,10
2024-07-10,1008,B08,58.11,26,2024-06-29,233,78,155
2024-07-11,1008,B08,58.86,24,2024-06-29,170,52,118
2024-07-12,1008,B08,56.91,24,2024-06-29,247,89,158
2024-07-13,1008,B08,57.38,25,2024-06-29,124,81,43
2024-07-14,1008,B08,57.46,26,2024-06-29,201,74,127
2024-07-15,1008,B08,58.57,26,2024-06-29,292,50,242
2024-07-16,1008,B08,57.71,26,2024-06-29,55,21,34
2024-07-17,1008,B08,58.04,26,2024-06-29,53,34,19
2024-07-18,1008,B08,58.52,24,2024-06-29,143,139,4
2024-07-19,1008,B08,58.34,25,2024-06-29,234,213,21
2024-07-20,1008,B08,58.0,25,2024-06-29,228,192,36
2024-07-21,1008,B08,58.43,25,2024-06-29,203,137,66
2024-07-22,1008,B08,58.31,24,2024-06-29,69,68,1
2024-07-23,1008,B08,57.95,24,2024-06-29,139,33,106
2024-07-24,1008,B08,57.47,24,2024-06-29,175,158,17
2024-07-25,1008,B08,58.75,24,2024-06-29,284,278,6
2024-07-26,1008,B08,56.99,25,2024-06-29,297,29,268
2024-07-27,1008,B08,57.99,25,2024-06-29,221,149,72
2024-07-28,1008,B08,57.53,25,2024-06-29,133,84,49
2024-07-29,1008,B08,57.17,24,2024-06-29,66,28,38
2024-07-30,1008,B08,58.08,25,2024-06-29,296,113,183
2024-07-01,1009,B09,18.85,26,2024-06-29,186,181,5
2024-07-02,1009,B09,18.96,26,2024-06-29,50,27,23
2024-07-03,1009,B09,20.04,24,2024-06-29,121,30,91
2024-07-04,1009,B09,20.19,25,2024-06-29,109,49,60
2024-07-05,1009,B09,20.25,24,2024-06-29,54,38,16
2024-07-06,1009,B09,19.93,25,2024-06-29,111,23,88
2024-07-07,1009,B09,19.23,25,2024-06-29,138,37,101
2024-07-08,1009,B09,20.23,26,2024-06-29,153,33,120
2024-07-09,1009,B09,20.4,24,2024-06-29,215,116,99
2024-07-10,1009,B09,20.1,26,2024-06-29,274,172,102
2024-07-11,1009,B09,19.31,26,2024-06-29,296,123,173
2024-07-12,1009,B09,19.06,26,2024-06-29,228,217,11
2024-07-13,1009,B09,20.48,26,2024-06-29,228,219,9
2024-07-14,1009,B09,19.99,26,2024-06-29,160,52,108
2024-07-15,1009,B09,19.67,26,2024-06-29,204,183,21
2024-07-16,1009,B09,20.6,24,2024-06-29,146,144,2
2024-07-17,1009,B09,19.1,26,2024-06-29,82,81,1
2024-07-18,1009,B09,19.01,25,2024-06-29,59,24,35
2024-07-19,1009,B09,20.35,24,2024-06-29,167,57,110
2024-07-20,1009,B09,19.67,26,2024-06-29,277,235,42
2024-07-21,1009,B09,19.81,26,2024-06-29,206,155,51
2024-07-22,1009,B09,18.9,26,2024-06-29,117,95,22
2024-07-23,1009,B09,20.14,26,2024-06-29,144,134,10
2024-07-24,1009,B09,19.99,25,2024-06-29,92,46,46
2024-07-25,1009,B09,19.29,26,2024-06-29,123,57,66
2024-07-26,1009,B09,19.05,26,2024-06-29,96,65,31
2024-07-27,1009,B09,19.83,25,2024-06-29,190,123,67
2024-07-28,1009,B09,19.61,24,2024-06-29,274,130,144
2024-07-29,1009,B09,20.05,26,2024-06-29,253,119,134
2024-07-30,1009,B09,20.44,24,2024-06-29,169,56,113
2024-07-01,1010,B10,73.8,10,2024-06-30,186,70,116
2024-07-02,1010,B10,74.12,9,2024-06-30,263,30,233
2024-07-03,1010,B10,73.55,10,2024-06-30,150,109,41
2024-07-04,1010,B10,74.33,10,2024-06-30,264,76,188
2024-07-05,1010,B10,73.31,10,2024-06-30,104,59,45
2024-07-06,1010,B10,73.87,11,2024-06-30,250,72,178
2024-07-07,1010,B10,73.32,9,2024-06-30,166,54,112
2024-07-08,1010,B10,73.45,9,2024-06-30,139,94,45
2024-07-09,1010,B10,74.5,11,2024-06-30,259,238,21
2024-07-10,1010,B10,74.13,9,2024-06-30,177,127,50
2024-07-11,1010,B10,74.48,10,2024-06-30,201,44,157
2024-07-12,1010,B10,73.65,10,2024-06-30,294,180,114
2024-07-13,1010,B10,73.37,11,2024-06-30,284,169,115
2024-07-14,1010,B10,73.09,10,2024-06-30,262,68,194
2024-07-15,1010,B10,73.01,9,2024-06-30,226,167,59
2024-07-16,1010,B10,73.48,11,2024-06-30,238,123,115
2024-07-17,1010,B10,73.65,9,2024-06-30,273,160,113
2024-07-18,1010,B10,73.44,11,2024-06-30,172,81,91
2024-07-19,1010,B10,73.06,9,2024-06-30,98,64,34
2024-07-20,1010,B10,73.41,11,2024-06-30,67,20,47
2024-07-21,1010,B10,74.2,11,2024-06-30,291,213,78
2024-07-22,1010,B10,73.72,9,2024-06-30,163,82,81
2024-07-23,1010,B10,72.86,9,2024-06-30,104,22,82
2024-07-24,1010,B10,73.4,10,2024-06-30,260,129,131
2024-07-25,1010,B10,73.7,9,2024-06-30,136,74,62
2024-07-26,1010,B10,72.96,10,2024-06-30,184,112,72
2024-07-27,1010,B10,73.47,9,2024-06-30,296,274,22
2024-07-28,1010,B10,72.69,10,2024-06-30,298,258,40
2024-07-29,1010,B10,73.79,11,2024-06-30,146,111,35
2024-07-30,1010,B10,73.13,10,2024-06-30,84,51,33
2024-07-01,1011,B11,99.88,30,2024-06-27,262,161,101
2024-07-02,1011,B11,98.58,30,2024-06-27,56,29,27
2024-07-03,1011,B11,98.16,31,2024-06-27,134,38,96
2024-07-04,1011,B11,98.24,31,2024-06-27,85,48,37
2024-07-05,1011,B11,98.83,30,2024-06-27,178,66,112
2024-07-06,1011,B11,99.24,31,2024-06-27,283,214,69
2024-07-07,1011,B11,99.17,29,2024-06-27,86,57,29
2024-07-08,1011,B11,99.54,29,2024-06-27,275,72,203
2024-07-09,1011,B11,98.58,30,2024-06-27,135,127,8
2024-07-10,1011,B11,98.27,30,2024-06-27,207,139,68
2024-07-11,1011,B11,99.96,31,2024-06-27,177,133,44
2024-07-12,1011,B11,98.03,30,2024-06-27,58,21,37
2024-07-13,1011,B11,99.26,31,2024-06-27,250,41,209
2024-07-14,1011,B11,99.66,30,2024-06-27,235,48,187
2024-07-15,1011,B11,98.33,31,2024-06-27,86,37,49
2024-07-16,1011,B11,99.05,30,2024-06-27,149,60,89
2024-07-17,1011,B11,98.54,29,2024-06-27,214,172,42
2024-07-18,1011,B11,98.98,31,2024-06-27,166,125,41
2024-07-19,1011,B11,98.27,31,2024-06-27,106,50,56
2024-07-20,1011,B11,99.74,30,2024-06-27,61,26,35
2024-07-21,1011,B11,99.14,29,2024-06-27,203,141,62
2024-07-22,1011,B11,98.83,30,2024-06-27,103,84,19
2024-07-23,1011,B11,98.16,31,2024-06-27,75,48,27
2024-07-24,1011,B11,98.77,31,2024-06-27,213,132,81
2024-07-25,1011,B11,99.43,31,2024-06-27,103,74,29
2024-07-26,1011,B11,99.32,30,2024-06-27,199,88,111
2024-07-27,1011,B11,98.96,30,2024-06-27,85,39,46
2024-07-28,1011,B11,98.31,31,2024-06-27,130,81,49
2024-07-29,1011,B11,99.9,31,2024-06-27,275,220,55
2024-07-30,1011,B11,99.53,29,2024-06-27,122,92,30
2024-07-01,1012,B12,42.05,5,2024-06-22,74,58,16
2024-07-02,1012,B12,40.79,5,2024-06-22,278,127,151
2024-07-03,1012,B12,42.03,5,2024-06-22,151,117,34
2024-07-04,1012,B12,40.85,4,2024-06-22,93,78,15
2024-07-05,1012,B12,42.47,4,2024-06-22,66,29,37
2024-07-06,1012,B12,42.02,4,2024-06-22,96,31,65
2024-07-07,1012,B12,41.72,6,2024-06-22,57,50,7
2024-07-08,1012,B12,42.25,6,2024-06-22,278,217,61
2024-07-09,1012,B12,42.6,5,2024-06-22,138,31,107
2024-07-10,1012,B12,41.08,5,2024-06-22,282,45,237
2024-07-11,1012,B12,40.72,5,2024-06-22,65,26,39
2024-07-12,1012,B12,42.64,5,2024-06-22,262,105,157
2024-07-13,1012,B12,42.47,5,2024-06-22,128,26,102
2024-07-14,1012,B12,41.23,5,2024-06-22,108,106,2
2024-07-15,1012,B12,42.23,6,2024-06-22,271,135,136
2024-07-16,1012,B12,42.33,5,2024-06-22,236,122,114
2024-07-17,1012,B12,40.71,6,2024-06-22,201,127,74
2024-07-18,1012,B12,40.88,5,2024-06-22,180,56,124
2024-07-19,1012,B12,41.7,5,2024-06-22,232,127,105
2024-07-20,1012,B12,41.78,4,2024-06-22,53,48,5
2024-07-21,1012,B12,41.96,4,2024-06-22,259,180,79
2024-07-22,1012,B12,42.41,5,2024-06-22,157,145,12
2024-07-23,1012,B12,41.48,6,2024-06-22,219,53,166
2024-07-24,1012,B12,40.68,6,2024-06-22,62,32,30
2024-07-25,1012,B12,41.41,6,2024-06-22,172,58,114
2024-07-26,1012,B12,40.66,4,2024-06-22,239,81,158
2024-07-27,1012,B12,41.6,4,2024-06-22,65,63,2
2024-07-28,1012,B12,42.61,5,2024-06-22,207,172,35
2024-07-29,1012,B12,41.31,4,2024-06-22,114,113,1
2024-07-30,1012,B12,40.65,4,2024-06-22,191,139,52
2024-07-01,1013,B13,35.32,19,2024-06-29,225,212,13
2024-07-02,1013,B13,36.67,21,2024-06-29,122,34,88
2024-07-03,1013,B13,35.62,21,2024-06-29,299,80,219
2024-07-04,1013,B13,35.37,20,2024-06-29,88,75,13
2024-07-05,1013,B13,36.62,21,2024-06-29,111,96,15
2024-07-06,1013,B13,36.83,21,2024-06-29,101,23,78
2024-07-07,1013,B13,35.31,19,2024-06-29,112,73,39
2024-07-08,1013,B13,36.07,19,2024-06-29,159,93,66
2024-07-09,1013,B13,34.94,19,2024-06-29,267,188,79
2024-07-10,1013,B13,35.22,21,2024-06-29,169,25,144
2024-07-11,1013,B13,36.45,20,2024-06-29,96,68,28
2024-07-12,1013,B13,35.89,20,2024-06-29,290,80,210
2024-07-13,1013,B13,35.37,21,2024-06-29,227,101,126
2024-07-14,1013,B13,36.24,21,2024-06-29,209,32,177
2024-07-15,1013,B13,35.3,21,2024-06-29,138,92,46
2024-07-16,1013,B13,36.64,19,2024-06-29,147,30,117
2024-07-17,1013,B13,36.6,21,2024-06-29,172,48,124
2024-07-18,1013,B13,36.63,19,2024-06-29,275,95,180
2024-07-19,1013,B13,34.92,21,2024-06-29,89,44,45
2024-07-20,1013,B13,35.95,21,2024-06-29,275,235,40
2024-07-21,1013,B13,35.36,20,2024-06-29,121,24,97
2024-07-22,1013,B13,34.95,20,2024-06-29,247,56,191
2024-07-23,1013,B13,35.29,19,2024-06-29,77,24,53
2024-07-24,1013,B13,36.83,20,2024-06-29,89,64,25
2024-07-25,1013,B13,35.81,19,2024-06-29,164,86,78
2024-07-26,1013,B13,35.55,20,2024-06-29,89,52,37
2024-07-27,1013,B13,36.61,21,2024-06-29,129,59,70
2024-07-28,1013,B13,35.34,21,2024-06-29,108,67,41
2024-07-29,1013,B13,36.27,21,2024-06-29,94,72,22
2024-07-30,1013,B13,36.21,21,2024-06-29,204,185,19
2024-07-01,1014,B14,26.09,26,2024-06-22,219,157,62
2024-07-02,1014,B14,27.67,24,2024-06-22,207,58,149
2024-07-03,1014,B14,26.35,25,2024-06-22,255,96,159
2024-07-04,1014,B14,27.04,26,2024-06-22,243,32,211
2024-07-05,1014,B14,27.26,24,2024-06-22,282,36,246
2024-07-06,1014,B14,26.26,25,2024-06-22,237,211,26
2024-07-07,1014,B14,27.11,26,2024-06-22,289,93,196
2024-07-08,1014,B14,26.89,25,2024-06-22,112,47,65
2024-07-09,1014,B14,27.3,25,2024-06-22,86,41,45
2024-07-10,1014,B14,27.9,25,2024-06-22,117,110,7
2024-07-11,1014,B14,26.36,25,2024-06-22,194,157,37
2024-07-12,1014,B14,26.98,25,2024-06-22,267,139,128
2024-07-13,1014,B14,26.12,25,2024-06-22,63,48,15
2024-07-14,1014,B14,26.92,26,2024-06-22,276,199,77
2024-07-15,1014,B14,27.55,26,2024-06-22,78,30,48
2024-07-16,1014,B14,27.67,26,2024-06-22,128,51,77
2024-07-17,1014,B14,27.57,25,2024-06-22,264,45,219
2024-07-18,1014,B14,26.35,25,2024-06-22,78,23,55
2024-07-19,1014,B14,26.88,24,2024-06-22,282,58,224
2024-07-20,1014,B14,27.08,24,2024-06-22,206,94,112
2024-07-21,1014,B14,26.47,25,2024-06-22,224,103,121
2024-07-22,1014,B14,27.34,26,2024-06-22,244,100,144
2024-07-23,1014,B14,27.96,24,2024-06-22,70,66,4
2024-07-24,1014,B14,26.87,26,2024-06-22,133,25,108
2024-07-25,1014,B14,27.55,24,2024-06-22,180,20,160
2024-07-26,1014,B14,26.67,25,2024-06-22,64,53,11
2024-07-27,1014,B14,26.46,24,2024-06-22,74,43,31
2024-07-28,1014,B14,26.77,26,2024-06-22,285,227,58
2024-07-29,1014,B14,27.12,25,2024-06-22,266,164,102
2024-07-30,1014,B14,26.21,26,2024-06-22,76,65,11
2024-07-01,1015,B15,58.55,15,2024-06-26,180,167,13
2024-07-02,1015,B15,58.32,14,2024-06-26,271,225,46
2024-07-03,1015,B15,57.93,15,2024-06-26,285,247,38
2024-07-04,1015,B15,57.85,14,2024-06-26,237,82,155
2024-07-05,1015,B15,58.03,14,2024-06-26,166,149,17
2024-07-06,1015,B15,58.33,16,2024-06-26,113,96,17
2024-07-07,1015,B15,57.03,14,2024-06-26,67,49,18
2024-07-08,1015,B15,57.51,15,2024-06-26,288,114,174
2024-07-09,1015,B15,58.17,16,2024-06-26,94,52,42
2024-07-10,1015,B15,58.64,14,2024-06-26,185,30,155
2024-07-11,1015,B15,57.69,14,2024-06-26,194,95,99
2024-07-12,1015,B15,58.7,16,2024-06-26,129,73,56
2024-07-13,1015,B15,57.97,14,2024-06-26,251,187,64
2024-07-14,1015,B15,56.75,14,2024-06-26,51,20,31
2024-07-15,1015,B15,56.91,14,2024-06-26,207,180,27
2024-07-16,1015,B15,58.38,15,2024-06-26,199,122,77
2024-07-17,1015,B15,57.0,16,2024-06-26,139,65,74
2024-07-18,1015,B15,58.12,16,2024-06-26,275,125,150
2024-07-19,1015,B15,57.06,14,2024-06-26,153,80,73
2024-07-20,1015,B15,58.14,15,2024-06-26,58,25,33
2024-07-21,1015,B15,57.96,16,2024-06-26,209,60,149
2024-07-22,1015,B15,58.15,15,2024-06-26,141,81,60
2024-07-23,1015,B15,58.3,16,2024-06-26,176,26,150
2024-07-24,1015,B15,58.05,15,2024-06-26,107,41,66
2024-07-25,1015,B15,57.63,16,2024-06-26,176,60,116
2024-07-26,1015,B15,57.06,15,2024-06-26,252,229,23
2024-07-27,1015,B15,56.85,16,2024-06-26,61,32,29
2024-07-28,1015,B15,57.69,16,2024-06-26,171,166,5
2024-07-29,1015,B15,58.68,14,2024-06-26,185,138,47
2024-07-30,1015,B15,57.6,16,2024-06-26,93,89,4
2024-07-01,1016,B16,75.72,29,2024-06-26,108,22,86
2024-07-02,1016,B16,73.89,31,2024-06-26,84,80,4
2024-07-03,1016,B16,73.87,31,2024-06-26,256,116,140
2024-07-04,1016,B16,75.41,29,2024-06-26,143,104,39
2024-07-05,1016,B16,75.18,29,2024-06-26,73,39,34
2024-07-06,1016,B16,74.99,30,2024-06-26,69,43,26
2024-07-07,1016,B16,74.82,31,2024-06-26,145,124,21
2024-07-08,1016,B16,74.61,29,2024-06-26,147,119,28
2024-07-09,1016,B16,75.48,30,2024-06-26,213,25,188
2024-07-10,1016,B16,75.04,31,2024-06-26,164,144,20
2024-07-11,1016,B16,74.15,29,2024-06-26,67,59,8
2024-07-12,1016,B16,75.4,29,2024-06-26,148,45,103
2024-07-13,1016,B16,75.16,30,2024-06-26,136,61,75
2024-07-14,1016,B16,74.21,30,2024-06-26,51,42,9
2024-07-15,1016,B16,74.56,30,2024-06-26,286,60,226
2024-07-16,1016,B16,74.22,29,2024-06-26,160,33,127
2024-07-17,1016,B16,74.76,29,2024-06-26,133,21,112
2024-07-18,1016,B16,73.92,29,2024-06-26,172,108,64
2024-07-19,1016,B16,75.67,30,2024-06-26,212,24,188
2024-07-20,1016,B16,74.38,29,2024-06-26,200,66,134
2024-07-21,1016,B16,74.2,30,2024-06-26,244,137,107
2024-07-22,1016,B16,74.07,30,2024-06-26,142,29,113
2024-07-23,1016,B16,75.07,29,2024-06-26,50,24,26
2024-07-24,1016,B16,74.23,31,2024-06-26,253,20,233
2024-07-25,1016,B16,74.24,30,2024-06-26,261,47,214
2024-07-26,1016,B16,73.8,29,2024-06-26,224,223,1
2024-07-27,1016,B16,74.68,29,2024-06-26,169,63,106
2024-07-28,1016,B16,74.62,31,2024-06-26,256,153,103
2024-07-29,1016,B16,74.14,29,2024-06-26,197,133,64
2024-07-30,1016,B16,75.7,29,2024-06-26,86,39,47
2024-07-01,1017,B17,14.1,4,2024-06-24,294,78,216
2024-07-02,1017,B17,14.28,4,2024-06-24,228,225,3
2024-07-03,1017,B17,15.03,4,2024-06-24,291,235,56
2024-07-04,1017,B17,15.02,5,2024-06-24,275,236,39
2024-07-05,1017,B17,14.93,4,2024-06-24,88,75,13
2024-07-06,1017,B17,14.68,5,2024-06-24,200,191,9
2024-07-07,1017,B17,14.71,6,2024-06-24,177,145,32
2024-07-08,1017,B17,14.27,5,2024-06-24,283,27,256
2024-07-09,1017,B17,15.59,4,2024-06-24,296,283,13
2024-07-10,1017,B17,13.96,5,2024-06-24,54,41,13
2024-07-11,1017,B17,14.16,4,2024-06-24,104,62,42
2024-07-12,1017,B17,15.02,5,2024-06-24,259,164,95
2024-07-13,1017,B17,15.31,6,2024-06-24,281,95,186
2024-07-14,1017,B17,13.88,4,2024-06-24,95,87,8
2024-07-15,1017,B17,15.0,6,2024-06-24,80,35,45
2024-07-16,1017,B17,15.3,4,2024-06-24,154,109,45
2024-07-17,1017,B17,14.35,5,2024-06-24,291,211,80
2024-07-18,1017,B17,13.75,4,2024-06-24,210,188,22
2024-07-19,1017,B17,15.64,4,2024-06-24,122,96,26
2024-07-20,1017,B17,14.23,6,2024-06-24,117,23,94
2024-07-21,1017,B17,14.99,5,2024-06-24,275,101,174
2024-07-22,1017,B17,15.41,6,2024-06-24,132,128,4
2024-07-23,1017,B17,15.29,5,2024-06-24,103,90,13
2024-07-24,1017,B17,13.66,6,2024-06-24,114,95,19
2024-07-25,1017,B17,14.87,6,2024-06-24,198,166,32
2024-07-26,1017,B17,14.43,4,2024-06-24,210,68,142
2024-07-27,1017,B17,14.74,6,2024-06-24,221,121,100
2024-07-28,1017,B17,13.8,6,2024-06-24,249,129,120
2024-07-29,1017,B17,14.94,5,2024-06-24,223,28,195
2024-07-30,1017,B17,14.41,5,2024-06-24,121,67,54
2024-07-01,1018,B18,86.88,19,2024-06-26,61,24,37
2024-07-02,1018,B18,86.05,19,2024-06-26,256,63,193
2024-07-03,1018,B18,86.2,21,2024-06-26,225,106,119
2024-07-04,1018,B18,86.88,20,2024-06-26,157,142,15
2024-07-05,1018,B18,86.29,19,2024-06-26,200,126,74
2024-07-06,1018,B18,85.27,21,2024-06-26,166,143,23
2024-07-07,1018,B18,87.16,21,2024-06-26,100,34,66
2024-07-08,1018,B18,85.64,19,2024-06-26,263,38,225
2024-07-09,1018,B18,85.45,19,2024-06-26,245,136,109
2024-07-10,1018,B18,85.82,21,2024-06-26,206,175,31
2024-07-11,1018,B18,86.33,20,2024-06-26,213,177,36
2024-07-12,1018,B18,86.68,19,2024-06-26,126,23,103
2024-07-13,1018,B18,86.9,20,2024-06-26,252,26,226
2024-07-14,1018,B18,86.61,20,2024-06-26,88,32,56
2024-07-15,1018,B18,85.62,21,2024-06-26,105,61,44
2024-07-16,1018,B18,85.62,20,2024-06-26,56,20,36
2024-07-17,1018,B18,86.0,19,2024-06-26,155,66,89
2024-07-18,1018,B18,87.15,21,2024-06-26,199,137,62
2024-07-19,1018,B18,86.28,19,2024-06-26,75,28,47
2024-07-20,1018,B18,86.54,20,2024-06-26,170,144,26
2024-07-21,1018,B18,87.06,19,2024-06-26,203,110,93
2024-07-22,1018,B18,86.81,20,2024-06-26,201,38,163
2024-07-23,1018,B18,86.95,21,2024-06-26,251,108,143
2024-07-24,1018,B18,85.44,20,2024-06-26,274,202,72
2024-07-25,1018,B18,86.42,21,2024-06-26,98,52,46
2024-07-26,1018,B18,85.68,19,2024-06-26,199,195,4
2024-07-27,1018,B18,85.87,21,2024-06-26,269,218,51
2024-07-28,1018,B18,86.34,20,2024-06-26,250,97,153
2024-07-29,1018,B18,86.51,19,2024-06-26,202,21,181
2024-07-30,1018,B18,85.8,21,2024-06-26,134,37,97
2024-07-01,1019,B19,46.84,31,2024-06-24,280,207,73
2024-07-02,1019,B19,47.03,30,2024-06-24,151,61,90
2024-07-03,1019,B19,47.2,29,2024-06-24,287,55,232
2024-07-04,1019,B19,45.56,29,2024-06-24,213,150,63
2024-07-05,1019,B19,46.19,29,2024-06-24,172,89,83
2024-07-06,1019,B19,46.1,29,2024-06-24,98,79,19
2024-07-07,1019,B19,45.53,29,2024-06-24,221,46,175
2024-07-08,1019,B19,46.67,30,2024-06-24,249,69,180
2024-07-09,1019,B19,46.75,29,2024-06-24,107,22,85
2024-07-10,1019,B19,45.77,30,2024-06-24,264,191,73
2024-07-11,1019,B19,46.71,29,2024-06-24,84,53,31
2024-07-12,1019,B19,46.28,30,2024-06-24,93,77,16
2024-07-13,1019,B19,47.31,29,2024-06-24,270,50,220
2024-07-14,1019,B19,46.9,31,2024-06-24,257,125,132
2024-07-15,1019,B19,45.58,29,2024-06-24,104,35,69
2024-07-16,1019,B19,45.39,31,2024-06-24,193,49,144
2024-07-17,1019,B19,45.86,31,2024-06-24,153,137,16
2024-07-18,1019,B19,47.37,29,2024-06-24,170,49,121
2024-07-19,1019,B19,46.43,30,2024-06-24,199,51,148
2024-07-20,1019,B19,45.65,30,2024-06-24,293,245,48
2024-07-21,1019,B19,45.52,29,2024-06-24,200,133,67
2024-07-22,1019,B19,46.07,29,2024-06-24,134,21,113
2024-07-23,1019,B19,47.26,29,2024-06-24,242,94,148
2024-07-24,1019,B19,47.04,30,2024-06-24,200,173,27
2024-07-25,1019,B19,46.59,31,2024-06-24,55,54,1
2024-07-26,1019,B19,46.96,31,2024-06-24,135,79,56
2024-07-27,1019,B19,47.09,30,2024-06-24,61,57,4
2024-07-28,1019,B19,47.02,31,2024-06-24,207,177,30
2024-07-29,1019,B19,46.83,31,2024-06-24,129,26,103
2024-07-30,1019,B19,46.0,29,2024-06-24,192,168,24
2024-07-01,1020,B20,11.51,15,2024-06-29,69,37,32
2024-07-02,1020,B20,12.34,14,2024-06-29,243,44,199
2024-07-03,1020,B20,12.02,14,2024-06-29,213,114,99
2024-07-04,1020,B20,12.03,15,2024-06-29,129,73,56
2024-07-05,1020,B20,12.72,16,2024-06-29,276,188,88
2024-07-06,1020,B20,12.71,14,2024-06-29,166,155,11
2024-07-07,1020,B20,12.02,14,2024-06-29,128,87,41
2024-07-08,1020,B20,11.22,14,2024-06-29,80,33,47
2024-07-09,1020,B20,12.81,14,2024-06-29,109,82,27
2024-07-10,1020,B20,12.34,14,2024-06-29,92,21,71
2024-07-11,1020,B20,12.36,16,2024-06-29,80,70,10
2024-07-12,1020,B20,12.19,15,2024-06-29,59,44,15
2024-07-13,1020,B20,11.18,16,2024-06-29,227,178,49
2024-07-14,1020,B20,12.45,14,2024-06-29,264,102,162
2024-07-15,1020,B20,11.4,14,2024-06-29,122,47,75
2024-07-16,1020,B20,11.67,16,2024-06-29,56,35,21
2024-07-17,1020,B20,12.44,14,2024-06-29,53,23,30
2024-07-18,1020,B20,13.05,14,2024-06-29,150,122,28
2024-07-19,1020,B20,11.5,14,2024-06-29,101,55,46
2024-07-20,1020,B20,12.11,16,2024-06-29,227,82,145
2024-07-21,1020,B20,12.64,16,2024-06-29,111,26,85
2024-07-22,1020,B20,12.11,15,2024-06-29,63,26,37
2024-07-23,1020,B20,12.53,15,2024-06-29,182,149,33
2024-07-24,1020,B20,11.33,14,2024-06-29,295,249,46
2024-07-25,1020,B20,11.58,15,2024-06-29,264,77,187
2024-07-26,1020,B20,11.44,14,2024-06-29,114,32,82
2024-07-27,1020,B20,11.08,15,2024-06-29,286,232,54
2024-07-28,1020,B20,11.46,14,2024-06-29,222,179,43
2024-07-29,1020,B20,12.04,16,2024-06-29,290,207,83
2024-07-30,1020,B20,12.35,14,2024-06-29,101,74,27
2024-07-01,1021,B21,24.16,30,2024-06-27,281,246,35
2024-07-02,1021,B21,23.18,29,2024-06-27,215,61,154
2024-07-03,1021,B21,24.0,29,2024-06-27,162,124,38
2024-07-04,1021,B21,22.63,29,2024-06-27,218,148,70
2024-07-05,1021,B21,24.05,29,2024-06-27,146,29,117
2024-07-06,1021,B21,24.29,29,2024-06-27,77,30,47
2024-07-07,1021,B21,23.42,31,2024-06-27,263,219,44
2024-07-08,1021,B21,22.88,29,2024-06-27,237,106,131
2024-07-09,1021,B21,23.47,31,2024-06-27,118,51,67
2024-07-10,1021,B21,24.41,31,2024-06-27,150,27,123
2024-07-11,1021,B21,22.51,29,2024-06-27,136,62,74
2024-07-12,1021,B21,23.75,31,2024-06-27,201,171,30
2024-07-13,1021,B21,22.5,29,2024-06-27,281,247,34
2024-07-14,1021,B21,23.13,31,2024-06-27,260,154,106
2024-07-15,1021,B21,24.0,31,2024-06-27,284,280,4
2024-07-16,1021,B21,23.53,30,2024-06-27,145,27,118
2024-07-17,1021,B21,22.96,30,2024-06-27,160,131,29
2024-07-18,1021,B21,24.37,31,2024-06-27,185,123,62
2024-07-19,1021,B21,23.68,30,2024-06-27,256,197,59
2024-07-20,1021,B21,22.45,30,2024-06-27,117,97,20
2024-07-21,1021,B21,22.57,29,2024-06-27,171,138,33
2024-07-22,1021,B21,22.51,30,2024-06-27,59,40,19
2024-07-23,1021,B21,22.68,31,2024-06-27,281,277,4
2024-07-24,1021,B21,23.63,29,2024-06-27,209,114,95
2024-07-25,1021,B21,23.47,30,2024-06-27,60,29,31
2024-07-26,1021,B21,23.11,30,2024-06-27,232,220,12
2024-07-27,1021,B21,23.17,31,2024-06-27,127,108,19
2024-07-28,1021,B21,22.76,30,2024-06-27,261,232,29
2024-07-29,1021,B21,23.78,31,2024-06-27,223,132,91
2024-07-30,1021,B21,23.72,31,2024-06-27,171,51,120
2024-07-01,1022,B22,38.61,4,2024-06-22,190,168,22
2024-07-02,1022,B22,39.48,5,2024-06-22,153,105,48
2024-07-03,1022,B22,39.03,4,2024-06-22,71,47,24
2024-07-04,1022,B22,37.61,5,2024-06-22,51,48,3
2024-07-05,1022,B22,38.89,6,2024-06-22,99,98,1
2024-07-06,1022,B22,38.53,4,2024-06-22,71,62,9
2024-07-07,1022,B22,39.04,4,2024-06-22,233,22,211
2024-07-08,1022,B22,38.12,6,2024-06-22,72,48,24
2024-07-09,1022,B22,37.71,6,2024-06-22,74,56,18
2024-07-10,1022,B22,37.84,5,2024-06-22,235,163,72
2024-07-11,1022,B22,39.14,4,2024-06-22,52,20,32
2024-07-12,1022,B22,38.08,6,2024-06-22,273,83,190
2024-07-13,1022,B22,39.12,6,2024-06-22,266,29,237
2024-07-14,1022,B22,39.0,5,2024-06-22,280,238,42
2024-07-15,1022,B22,37.9,4,2024-06-22,161,32,129
2024-07-16,1022,B22,38.6,5,2024-06-22,283,109,174
2024-07-17,1022,B22,39.2,4,2024-06-22,255,33,222
2024-07-18,1022,B22,39.02,4,2024-06-22,170,39,131
2024-07-19,1022,B22,38.17,6,2024-06-22,272,266,6
2024-07-20,1022,B22,38.46,6,2024-06-22,150,130,20
2024-07-21,1022,B22,38.42,5,2024-06-22,73,54,19
2024-07-22,1022,B22,37.8,5,2024-06-22,262,73,189
2024-07-23,1022,B22,38.91,4,2024-06-22,251,57,194
2024-07-24,1022,B22,37.85,4,2024-06-22,222,39,183
2024-07-25,1022,B22,38.32,6,2024-06-22,53,48,5
2024-07-26,1022,B22,38.8,4,2024-06-22,129,77,52
2024-07-27,1022,B22,38.64,5,2024-06-22,73,53,20
2024-07-28,1022,B22,38.72,6,2024-06-22,208,207,1
2024-07-29,1022,B22,39.17,4,2024-06-22,112,102,10
2024-07-30,1022,B22,37.64,4,2024-06-22,125,49,76
2024-07-01,1023,B23,98.41,24,2024-06-27,277,202,75
2024-07-02,1023,B23,98.85,24,2024-06-27,195,82,113
2024-07-03,1023,B23,97.82,26,2024-06-27,269,66,203
2024-07-04,1023,B23,99.38,25,2024-06-27,94,52,42
2024-07-05,1023,B23,98.22,26,2024-06-27,268,162,106
2024-07-06,1023,B23,98.2,25,2024-06-27,173,94,79
2024-07-07,1023,B23,98.86,25,2024-06-27,193,88,105
2024-07-08,1023,B23,97.75,24,2024-06-27,187,69,118
2024-07-09,1023,B23,97.71,26,2024-06-27,162,113,49
2024-07-10,1023,B23,99.04,24,2024-06-27,247,100,147
2024-07-11,1023,B23,99.24,26,2024-06-27,294,54,240
2024-07-12,1023,B23,98.24,26,2024-06-27,118,112,6
2024-07-13,1023,B23,98.3,24,2024-06-27,198,93,105
2024-07-14,1023,B23,99.25,25,2024-06-27,139,23,116
2024-07-15,1023,B23,97.48,26,2024-06-27,291,148,143
2024-07-16,1023,B23,98.94,25,2024-06-27,90,73,17
2024-07-17,1023,B23,97.83,24,2024-06-27,80,39,41
2024-07-18,1023,B23,98.69,24,2024-06-27,207,171,36
2024-07-19,1023,B23,97.49,25,2024-06-27,135,111,24
2024-07-20,1023,B23,97.93,26,2024-06-27,269,33,236
2024-07-21,1023,B23,97.88,25,2024-06-27,272,125,147
2024-07-22,1023,B23,99.07,25,2024-06-27,93,92,1
2024-07-23,1023,B23,98.36,26,2024-06-27,133,101,32
2024-07-24,1023,B23,99.19,24,2024-06-27,70,23,47
2024-07-25,1023,B23,98.01,26,2024-06-27,56,25,31
2024-07-26,1023,B23,99.18,25,2024-06-27,209,167,42
2024-07-27,1023,B23,97.64,26,2024-06-27,198,189,9
2024-07-28,1023,B23,99.04,25,2024-06-27,106,56,50
2024-07-29,1023,B23,99.34,25,2024-06-27,118,22,96
2024-07-30,1023,B23,98.83,24,2024-06-27,265,68,197
2024-07-01,1024,B24,51.97,4,2024-06-26,238,188,50
2024-07-02,1024,B24,50.79,4,2024-06-26,245,146,99
2024-07-03,1024,B24,51.25,6,2024-06-26,135,52,83
2024-07-04,1024,B24,51.8,4,2024-06-26,110,47,63
2024-07-05,1024,B24,52.2,4,2024-06-26,216,105,111
2024-07-06,1024,B24,51.85,5,2024-06-26,247,217,30
2024-07-07,1024,B24,52.44,5,2024-06-26,134,24,110
2024-07-08,1024,B24,52.64,4,2024-06-26,115,93,22
2024-07-09,1024,B24,51.67,6,2024-06-26,174,105,69
2024-07-10,1024,B24,51.33,6,2024-06-26,217,57,160
2024-07-11,1024,B24,52.36,5,2024-06-26,148,83,65
2024-07-12,1024,B24,52.34,4,2024-06-26,241,51,190
2024-07-13,1024,B24,51.27,5,2024-06-26,176,87,89
2024-07-14,1024,B24,52.26,5,2024-06-26,192,139,53
2024-07-15,1024,B24,51.0,6,2024-06-26,263,135,128
2024-07-16,1024,B24,52.49,6,2024-06-26,174,77,97
2024-07-17,1024,B24,52.25,4,2024-06-26,240,85,155
2024-07-18,1024,B24,50.88,5,2024-06-26,180,63,117
2024-07-19,1024,B24,51.83,6,2024-06-26,55,42,13
2024-07-20,1024,B24,52.39,5,2024-06-26,220,166,54
2024-07-21,1024,B24,51.63,6,2024-06-26,297,287,10
2024-07-22,1024,B24,51.8,4,2024-06-26,213,104,109
2024-07-23,1024,B24,51.37,4,2024-06-26,96,34,62
2024-07-24,1024,B24,52.58,5,2024-06-26,91,79,12
2024-07-25,1024,B24,52.14,5,2024-06-26,56,35,21
2024-07-26,1024,B24,52.46,6,2024-06-26,76,69,7
2024-07-27,1024,B24,51.09,5,2024-06-26,210,148,62
2024-07-28,1024,B24,50.82,4,2024-06-26,209,143,66
2024-07-29,1024,B24,52.39,4,2024-06-26,53,49,4
2024-07-30,1024,B24,51.98,5,2024-06-26,68,51,17
2024-07-01,1025,B25,21.52,16,2024-06-24,158,138,20
2024-07-02,1025,B25,19.83,15,2024-06-24,62,53,9
2024-07-03,1025,B25,19.92,15,2024-06-24,299,242,57
2024-07-04,1025,B25,20.9,16,2024-06-24,118,44,74
2024-07-05,1025,B25,19.78,14,2024-06-24,197,181,16
2024-07-06,1025,B25,20.01,15,2024-06-24,182,28,154
2024-07-07,1025,B25,21.23,15,2024-06-24,183,79,104
2024-07-08,1025,B25,20.22,16,2024-06-24,243,194,49
2024-07-09,1025,B25,20.89,14,2024-06-24,262,235,27
2024-07-10,1025,B25,20.58,16,2024-06-24,125,111,14
2024-07-11,1025,B25,20.64,14,2024-06-24,205,180,25
2024-07-12,1025,B25,20.07,15,2024-06-24,90,70,20
2024-07-13,1025,B25,20.49,15,2024-06-24,124,76,48
2024-07-14,1025,B25,20.46,15,2024-06-24,66,24,42
2024-07-15,1025,B25,21.2,15,2024-06-24,64,46,18
2024-07-16,1025,B25,20.86,14,2024-06-24,65,53,12
2024-07-17,1025,B25,20.24,16,2024-06-24,216,167,49
2024-07-18,1025,B25,20.04,16,2024-06-24,136,82,54
2024-07-19,1025,B25,20.27,15,2024-06-24,202,66,136
2024-07-20,1025,B25,20.2,16,2024-06-24,70,54,16
2024-07-21,1025,B25,21.12,14,2024-06-24,95,33,62
2024-07-22,1025,B25,21.4,14,2024-06-24,88,28,60
2024-07-23,1025,B25,21.17,14,2024-06-24,256,229,27
2024-07-24,1025,B25,20.89,15,2024-06-24,268,170,98
2024-07-25,1025,B25,19.93,15,2024-06-24,169,65,104
2024-07-26,1025,B25,20.51,14,2024-06-24,121,81,40
2024-07-27,1025,B25,20.35,15,2024-06-24,127,103,24
2024-07-28,1025,B25,19.63,15,2024-06-24,203,121,82
2024-07-29,1025,B25,20.15,14,2024-06-24,132,129,3
2024-07-30,1025,B25,21.41,15,2024-06-24,68,28,40
2024-07-01,1026,B26,85.79,24,2024-06-24,173,138,35
2024-07-02,1026,B26,85.62,26,2024-06-24,224,161,63
2024-07-03,1026,B26,84.99,24,2024-06-24,110,55,55
2024-07-04,1026,B26,84.74,25,2024-06-24,58,52,6
2024-07-05,1026,B26,85.49,24,2024-06-24,191,72,119
2024-07-06,1026,B26,85.14,26,2024-06-24,127,113,14
2024-07-07,1026,B26,85.75,26,2024-06-24,117,111,6
2024-07-08,1026,B26,86.25,24,2024-06-24,174,129,45
2024-07-09,1026,B26,85.23,26,2024-06-24,232,35,197
2024-07-10,1026,B26,85.03,24,2024-06-24,225,177,48
2024-07-11,1026,B26,85.41,26,2024-06-24,113,69,44
2024-07-12,1026,B26,85.7,24,2024-06-24,118,67,51
2024-07-13,1026,B26,86.21,26,2024-06-24,221,180,41
2024-07-14,1026,B26,86.03,24,2024-06-24,238,156,82
2024-07-15,1026,B26,85.89,24,2024-06-24,275,235,40
2024-07-16,1026,B26,86.46,24,2024-06-24,136,66,70
2024-07-17,1026,B26,84.71,25,2024-06-24,125,65,60
2024-07-18,1026,B26,86.1,24,2024-06-24,196,45,151
2024-07-19,1026,B26,84.88,25,2024-06-24,281,40,241
2024-07-20,1026,B26,85.81,24,2024-06-24,206,198,8
2024-07-21,1026,B26,85.02,26,2024-06-24,141,47,94
2024-07-22,1026,B26,85.02,24,2024-06-24,116,105,11
2024-07-23,1026,B26,85.08,25,2024-06-24,140,74,66
2024-07-24,1026,B26,86.52,26,2024-06-24,215,25,190
2024-07-25,1026,B26,86.33,25,2024-06-24,194,80,114
2024-07-26,1026,B26,85.49,25,2024-06-24,76,27,49
2024-07-27,1026,B26,85.03,25,2024-06-24,242,204,38
2024-07-28,1026,B26,85.21,24,2024-06-24,148,59,89
2024-07-29,1026,B26,85.49,24,2024-06-24,133,75,58
2024-07-30,1026,B26,85.73,24,2024-06-24,279,68,211
2024-07-01,1027,B27,9.76,29,2024-06-23,139,58,81
2024-07-02,1027,B27,11.3,29,2024-06-23,241,81,160
2024-07-03,1027,B27,10.48,30,2024-06-23,175,28,147
2024-07-04,1027,B27,11.32,29,2024-06-23,90,36,54
2024-07-05,1027,B27,9.92,31,2024-06-23,108,58,50
2024-07-06,1027,B27,10.84,31,2024-06-23,190,30,160
2024-07-07,1027,B27,9.78,31,2024-06-23,126,65,61
2024-07-08,1027,B27,10.02,31,2024-06-23,125,91,34
2024-07-09,1027,B27,11.51,29,2024-06-23,158,31,127
2024-07-10,1027,B27,11.04,29,2024-06-23,94,88,6
2024-07-11,1027,B27,9.69,31,2024-06-23,223,106,117
2024-07-12,1027,B27,11.13,31,2024-06-23,264,196,68
2024-07-13,1027,B27,10.9,30,2024-06-23,195,87,108
2024-07-14,1027,B27,10.46,31,2024-06-23,213,101,112
2024-07-15,1027,B27,9.87,31,2024-06-23,205,187,18
2024-07-16,1027,B27,11.19,29,2024-06-23,125,34,91
2024-07-17,1027,B27,11.19,30,2024-06-23,240,48,192
2024-07-18,1027,B27,11.05,30,2024-06-23,100,94,6
2024-07-19,1027,B27,10.89,30,2024-06-23,259,70,189
2024-07-20,1027,B27,11.52,29,2024-06-23,88,47,41
2024-07-21,1027,B27,10.03,30,2024-06-23,204,136,68
2024-07-22,1027,B27,11.49,30,2024-06-23,180,163,17
2024-07-23,1027,B27,11.67,30,2024-06-23,130,60,70
2024-07-24,1027,B27,10.53,31,2024-06-23,284,232,52
2024-07-25,1027,B27,11.31,31,2024-06-23,272,172,100
2024-07-26,1027,B27,11.15,29,2024-06-23,87,47,40
2024-07-27,1027,B27,10.46,31,2024-06-23,195,183,12
2024-07-28,1027,B27,11.04,31,2024-06-23,122,72,50
2024-07-29,1027,B27,11.41,30,2024-06-23,237,127,110
2024-07-30,1027,B27,11.29,31,2024-06-23,244,175,69
2024-07-01,1028,B28,61.77,5,2024-06-24,106,52,54
2024-07-02,1028,B28,62.18,5,2024-06-24,233,175,58
2024-07-03,1028,B28,61.99,4,2024-06-24,105,84,21
2024-07-04,1028,B28,61.82,6,2024-06-24,206,165,41
2024-07-05,1028,B28,62.4,6,2024-06-24,288,145,143
2024-07-06,1028,B28,62.32,4,2024-06-24,87,83,4
2024-07-07,1028,B28,62.34,5,2024-06-24,225,135,90
2024-07-08,1028,B28,62.29,5,2024-06-24,114,50,64
2024-07-09,1028,B28,62.51,4,2024-06-24,227,88,139
2024-07-10,1028,B28,61.59,6,2024-06-24,116,94,22
2024-07-11,1028,B28,61.4,5,2024-06-24,204,193,11
2024-07-12,1028,B28,61.19,6,2024-06-24,283,70,213
2024-07-13,1028,B28,61.18,6,2024-06-24,174,162,12
2024-07-14,1028,B28,62.11,5,2024-06-24,278,141,137
2024-07-15,1028,B28,61.36,5,2024-06-24,173,120,53
2024-07-16,1028,B28,62.08,5,2024-06-24,245,37,208
2024-07-17,1028,B28,62.78,4,2024-06-24,78,32,46
2024-07-18,1028,B28,62.34,5,2024-06-24,293,128,165
2024-07-19,1028,B28,63.07,5,2024-06-24,117,88,29
2024-07-20,1028,B28,61.44,4,2024-06-24,190,181,9
2024-07-21,1028,B28,61.47,4,2024-06-24,172,106,66
2024-07-22,1028,B28,62.01,5,2024-06-24,147,51,96
2024-07-23,1028,B28,62.55,5,2024-06-24,290,40,250
2024-07-24,1028,B28,63.06,6,2024-06-24,117,20,97
2024-07-25,1028,B28,62.29,4,2024-06-24,276,160,116
2024-07-26,1028,B28,62.38,6,2024-06-24,277,118,159
2024-07-27,1028,B28,62.89,5,2024-06-24,298,171,127
2024-07-28,1028,B28,62.37,4,2024-06-24,280,27,253
2024-07-29,1028,B28,61.21,4,2024-06-24,150,137,13
2024-07-30,1028,B28,61.59,6,2024-06-24,166,117,49
2024-07-01,1029,B29,74.25,26,2024-06-25,280,24,256
2024-07-02,1029,B29,75.58,24,2024-06-25,95,31,64
2024-07-03,1029,B29,75.93,26,2024-06-25,196,173,23
2024-07-04,1029,B29,75.95,25,2024-06-25,232,121,111
2024-07-05,1029,B29,75.03,25,2024-06-25,265,170,95
2024-07-06,1029,B29,74.76,26,2024-06-25,241,228,13
2024-07-07,1029,B29,75.72,25,2024-06-25,268,101,167
2024-07-08,1029,B29,74.88,26,2024-06-25,288,279,9
2024-07-09,1029,B29,75.6,26,2024-06-25,97,92,5
2024-07-10,1029,B29,74.11,24,2024-06-25,130,100,30
2024-07-11,1029,B29,75.68,26,2024-06-25,112,57,55
2024-07-12,1029,B29,74.5,24,2024-06-25,62,50,12
2024-07-13,1029,B29,75.46,25,2024-06-25,273,41,232
2024-07-14,1029,B29,75.37,26,2024-06-25,116,73,43
2024-07-15,1029,B29,75.04,25,2024-06-25,70,35,35
2024-07-16,1029,B29,75.63,24,2024-06-25,201,54,147
2024-07-17,1029,B29,74.41,24,2024-06-25,271,66,205
2024-07-18,1029,B29,75.97,25,2024-06-25,57,45,12
2024-07-19,1029,B29,75.65,26,2024-06-25,79,26,53
2024-07-20,1029,B29,74.08,24,2024-06-25,86,20,66
2024-07-21,1029,B29,74.13,24,2024-06-25,281,155,126
2024-07-22,1029,B29,75.53,24,2024-06-25,176,20,156
2024-07-23,1029,B29,75.68,25,2024-06-25,240,123,117
2024-07-24,1029,B29,74.79,25,2024-06-25,223,147,76
2024-07-25,1029,B29,75.36,26,2024-06-25,151,94,57
2024-07-26,1029,B29,74.69,26,2024-06-25,191,53,138
2024-07-27,1029,B29,74.0,26,2024-06-25,172,121,51
2024-07-28,1029,B29,74.59,24,2024-06-25,168,143,25
2024-07-29,1029,B29,75.4,25,2024-06-25,243,237,6
2024-07-30,1029,B29,74.8,26,2024-06-25,208,53,155
2024-07-01,1030,B30,35.1,31,2024-06-23,167,72,95
2024-07-02,1030,B30,35.97,29,2024-06-23,282,177,105
2024-07-03,1030,B30,36.25,29,2024-06-23,196,72,124
2024-07-04,1030,B30,35.12,29,2024-06-23,263,50,213
2024-07-05,1030,B30,36.07,31,2024-06-23,81,29,52
2024-07-06,1030,B30,35.46,30,2024-06-23,101,39,62
2024-07-07,1030,B30,35.66,30,2024-06-23,227,175,52
2024-07-08,1030,B30,34.76,29,2024-06-23,201,98,103
2024-07-09,1030,B30,35.4,31,2024-06-23,53,32,21
2024-07-10,1030,B30,36.12,30,2024-06-23,61,50,11
2024-07-11,1030,B30,34.86,30,2024-06-23,297,146,151
2024-07-12,1030,B30,34.4,29,2024-06-23,128,76,52
2024-07-13,1030,B30,34.29,30,2024-06-23,142,45,97
2024-07-14,1030,B30,35.72,30,2024-06-23,87,69,18
2024-07-15,1030,B30,35.22,30,2024-06-23,118,63,55
2024-07-16,1030,B30,35.77,29,2024-06-23,205,158,47
2024-07-17,1030,B30,35.94,31,2024-06-23,196,156,40
2024-07-18,1030,B30,35.98,30,2024-06-23,192,70,122
2024-07-19,1030,B30,35.16,29,2024-06-23,247,131,116
2024-07-20,1030,B30,36.16,31,2024-06-23,214,164,50
2024-07-21,1030,B30,35.66,30,2024-06-23,206,180,26
2024-07-22,1030,B30,36.15,29,2024-06-23,169,157,12
2024-07-23,1030,B30,34.57,29,2024-06-23,198,32,166
2024-07-24,1030,B30,34.66,31,2024-06-23,66,23,43
2024-07-25,1030,B30,35.7,30,2024-06-23,250,40,210
2024-07-26,1030,B30,35.24,31,2024-06-23,189,56,133
2024-07-27,1030,B30,34.39,29,2024-06-23,295,47,248
2024-07-28,1030,B30,36.02,31,2024-06-23,96,37,59
2024-07-29,1030,B30,35.56,31,2024-06-23,285,32,253
2024-07-30,1030,B30,35.12,29,2024-06-23,149,50,99
